[
    {
        "map": [
            [ 1, 1, 0, 2, 2, 2, 3, 2, 2, 2, 3 ],
            [ 1, 0, 2, 2, 2, 3, 2, 3, 2, 2 ],
            [ 1, 3, 0, 4, 2, 4, 0, 2, 3, 2, 2 ],
            [ 1, 1, 4, 4, 0, 0, 2, 3, 2, 2 ],
            [ 0, 0, 0, 0, 0, 0, 0, 0, 0, 0, 2 ],
            [ 0, 0, 0, 0, 0, 0, 2, 3, 2, 2 ]
        ],
        "next": [31 , 31, 31,31,31 ],
        "typeCount": 3,
        "maxScore":1000,
        "cellScore": 10
    },
    {
        "map": [
            [ 1, 1, 0, 2, 2, 2, 3, 2, 2, 2, 3 ],
            [ 1, 0, 2, 2, 2, 3, 2, 3, 2, 2 ],
            [ 1, 3, 0, 4, 2, 4, 0, 2, 3, 2, 2 ],
            [ 1, 1, 4, 4, 0, 0, 2, 3, 2, 2 ],
            [ 0, 0, 0, 0, 0, 0, 0, 0, 0, 0, 2 ],
            [ 1, 1, 4, 4, 0, 0, 2, 3, 2, 2 ]
        ],
        "typeCount": 3,
        "maxScore": 1000,
        "cellScore": 10,
        "baseScore": 11
    }
]