[
    {},
    {
        "lv": 1,
        "map": [
            [3, 3, 3, 3, 3, 2, 3, 3, 3, 3, 3],
            [3, 3, 3, 3, 2, 2, 3, 3, 3, 3 ],
            [3, 3, 3, 3, 2, 0, 2, 3, 3, 3, 3],
            [3, 3, 3, 2, 0, 0, 2, 3, 3, 3 ],
            [3, 3, 3, 2, 2, 2, 2, 2, 3, 3, 3],
            [3, 3, 2, 0, 0, 0, 0, 2, 3, 3 ],
            [3, 3, 2, 0, 0, 0, 0, 0, 2, 3, 3],
            [3, 2, 0, 0, 0, 0, 0, 0, 2, 3 ]
        ],
        "types": [2, 3 ],
        "maxScore": 1000,
        "cellScore": 5,
        "scoreLv": [30, 60, 100],
        "time": 25
    },
    {
        "lv": 2,
        "map": [
            [3, 3, 2, 3, 8, 8, 8, 3, 2, 3, 3],
            [3, 2, 3, 3, 3, 3, 3, 3, 2, 3 ],
            [3, 2, 8, 8, 8, 3, 8, 8, 8, 2, 3],
            [2, 8, 8, 8, 3, 3, 8, 8, 8, 2 ],
            [3, 2, 3, 3, 3, 3, 3, 3, 3, 2, 3],
            [2, 3, 3, 3, 3, 3, 3, 3, 3, 2 ],
            [3, 2, 3, 3, 8, 8, 8, 3, 3, 2, 3],
            [3, 2, 3, 8, 8, 8, 8, 3, 2, 3 ],
            [3, 3, 2, 2, 8, 8, 8, 2, 2, 3, 3]
        ],
        "types": [2, 3, 8],
        "next": [8, 3],
        "maxScore": 1500,
        "cellScore": 10,
        "time": 30
    },
    {
        "lv": 3,
        "map": [
            [1, 1, 0, 2, 2, 2, 3, 2, 2, 2, 3],
            [1, 0, 2, 2, 2, 3, 2, 3, 2, 2],
            [1, 3, 0, 4, 2, 4, 0, 2, 3, 2, 2],
            [1, 1, 4, 4, 0, 0, 2, 3, 2, 2],
            [0, 0, 0, 0, 0, 0, 0, 0, 0, 0, 2],
            [0, 0, 0, 0, 0, 0, 2, 3, 2, 2]
        ],
        "next": [1, 2, 3, 4, 31, 18],
        "typeCount": 3,
        "maxScore": 1000,
        "cellScore": 10,
        "time": 10
    }
]
